--------------
---------kkkkk
--------------
--------g-----
-------kk-----
------g-------
----kkkk------
--------------
---g----------
kkkkk---------
0 1
0
