--------------
--------gkkkkk
--------g-----
--------g-----
------gkk-----
------g-------
---gkkkk------
---g----------
---g----------
kkkkk---------
13 9
0
